PCF8574		KEYWORD1

begin		KEYWORD2

GetAddressWire	KEYWORD2
SetAddressWire	KEYWORD2

pinMode		KEYWORD2

ResetPinStatus 	KEYWORD2
SetPinStatus	KEYWORD2
ReadPinStatus	KEYWORD2
isStatusPin	KEYWORD2
DebugStatusPin	KEYWORD2

GetAddress	KEYWORD2
SetAddress	KEYWORD2

GetIniPin	KEYWORD2
SetIniPin	KEYWORD2
GetEndPin	KEYWORD2
SetEndPin	KEYWORD2
SetPins		KEYWORD2

PIN_STATUS_ON	LITERAL1
PIN_STATUS_OFF	LITERAL1
PIN_STATUS_ERR	LITERAL1

